Áà±Áî∞È£ûÈ∏ü	Áà±Áî∞È£ûÈ∏ü „ÅÇ„ÅÑ„Å†È£õÈ≥•
Áà±‰πÉÂ®úÁæé	Áà±‰πÉÂ®úÁæé ÊÑõ‰πÉ„Å™„Åø
ÂÆâÊñãÊãâÊãâ	ÂÆâÊñãÊãâÊãâ ÂÆâÈΩãÊãâÊãâ
Ëãç‰∫ïÁ©∫	Ëãç‰∫ïÁ©∫ Ëíº‰∫ï„Åù„Çâ
ÈïøË∞∑Â∑ùÁêÜÁ©ó	ÈïøË∞∑Â∑ùÁêÜÁ©ó Èï∑Ë∞∑Â∑ù„É™„Éõ
ÂΩ©ÁæéÊó¨Êûú	ÂΩ©ÁæéÊó¨Êûú „ÅÇ„ÇÑ„ÅøÊó¨Êûú
Êò•Âí≤Âáâ	Êò•Âí≤Âáâ Êò•Âí≤„Çä„Çá„ÅÜ
ËíÇ‰∫ö	ËíÇ‰∫ö ËíÇ‰∫û
Ê•™ÂèØÊÄú	Ê•™ÂèØÊÄú Ê•™„Ç´„É¨„É≥
Â¶ÉÊÇ†Áà±	Â¶ÉÊÇ†Áà± Â¶ÉÊÇ†ÊÑõ
Êû´Ëä±ÊÅã	Êû´Ëä±ÊÅã Ê•ì„Ç´„É¨„É≥
ÂÆ´‰∏ãÂçéÂ•à	ÂÆ´‰∏ãÂçéÂ•à ÂÆÆ‰∏ãËèØÂ•à
Âè§Â∑ù‰ºäÁªá	Âè§Â∑ù‰ºäÁªá Âè§Â∑ù„ÅÑ„Åä„Çä
ÂπøÊøëÈáåÁª™Ëèú	ÂπøÊøëÈáåÁª™Ëèú Â∫ÉÁÄ¨„Çä„Åä„Å™
Ê≤≥ÂåóÊò•Ëèú	Ê≤≥ÂåóÊò•Ëèú Ê≤≥Âåó„ÅØ„Çã„Å™
ÂêâÂ∑ùËé≤	ÂêâÂ∑ùËé≤ ÂêâÂ∑ùËìÆ
ÂêâÊ≥ΩÊòéÊ≠•	ÂêâÊ≥ΩÊòéÊ≠• ÂêâÊ≤¢ÊòéÊ≠©
ÈìÉÊùëÁà±Èáå	ÈìÉÊùëÁà±Èáå Èà¥Êùë„ÅÇ„ÅÑ„Çä
ÂáâÊ£ÆÁé≤Ê¢¶	ÂáâÊ£ÆÁé≤Ê¢¶ Ê∂ºÊ£Æ„Çå„ÇÄ
ÊûóÁî±Â•à	ÊûóÁî±Â•à Êûó„ÇÜ„Å™
ÂáõÈü≥Ê°ÉËä±	ÂáõÈü≥Ê°ÉËä± ÂáõÈü≥„Å®„ÅÜ„Åã
ÈáåÁæéÂ∞§Âà©Â®Ö	ÈáåÁæéÂ∞§Âà©Â®Ö ÈáåÁæé„ÇÜ„Çä„ÅÇ
Ëä¶ÂêçÂ∞§Ëéâ‰∫ö	Ëä¶ÂêçÂ∞§Ëéâ‰∫ö Ëä¶Âêç„É¶„É™„Ç¢
ÁæéÈõ™Áà±Ëéâ‰∏ù	ÁæéÈõ™Áà±Ëéâ‰∏ù ÁæéÈõ™„ÅÇ„Çä„Åô
ÁõÆÈªëÊÉ†	ÁõÆÈªëÊÉ† ÁõÆÈªí„ÇÅ„Åê„Åø
ÊòéÈáå‰å∑	ÊòéÈáå‰å∑ ÊòéÈáå„Å§„ÇÄ„Åé
‰∏ÉÊµ∑ËíÇÂ®ú	‰∏ÉÊµ∑ËíÇÂ®ú ‰∏ÉÊµ∑„ÉÜ„Ç£„Éä
Â§©Êµ∑Áøº	Â§©Êµ∑Áøº Â§©Êµ∑„Å§„Å∞„Åï
Ê°ÉË∞∑ÁªòÈáåÈ¶ô	Ê°ÉË∞∑ÁªòÈáåÈ¶ô Ê°ÉË∞∑„Ç®„É™„Ç´
Ëæª‰∫ïÁ©ó‰πÉÊûú	Ëæª‰∫ïÁ©ó‰πÉÊûú Ëæª‰∫ï„Åª„ÅÆ„Åã
Ê°•Êú¨ÊúâËèú	Ê°•Êú¨ÊúâËèú Ê©ãÊú¨„ÅÇ„Çä„Å™
Ê∑±Áî∞ÂíèÁæé	Ê∑±Áî∞ÂíèÁæé Ê∑±Áî∞„Åà„ÅÑ„Åø
‰∏â‰∏äÊÇ†‰∫ö	‰∏â‰∏äÊÇ†‰∫ö ‰∏â‰∏äÊÇ†‰∫ú
Ê°É‰πÉÊú®È¶ôÂ•à	Ê°É‰πÉÊú®È¶ôÂ•à Ê°É‰πÉÊú®„Åã„Å™
Ê≠¶Ëó§Áª´È¶ô	Ê≠¶Ëó§Áª´È¶ô Ê≠¶Ëó§„ÅÇ„ÇÑ„Åã
Â∏åÂ≤õÁà±ÁêÜ	Â∏åÂ≤õÁà±ÁêÜ Â∏åÂ≤õ„ÅÇ„ÅÑ„Çä
Â§èÂ∏åÊ†ó	Â§èÂ∏åÊ†ó Â§èÂ∏å„Åæ„Çç„Çì
Â∏åÂ¥éÊù∞Ë•øÂç°	Â∏åÂ¥éÊù∞Ë•øÂç° Â∏åÂ¥é„Ç∏„Çß„Ç∑„Ç´
Â∞èÊ≥ΩÁéõÂà©‰∫ö	Â∞èÊ≥ΩÁéõÂà©‰∫ö Â∞èÊæ§„Éû„É™„Ç¢
Â∞èÂ≤õÂçó	Â∞èÂ≤õÂçó Â∞èÂ≥∂„Åø„Å™„Åø
Áõ∏Ê≥ΩÂçó	Áõ∏Ê≥ΩÂçó Áõ∏Ê≤¢„Åø„Å™„Åø
ÊòüÂÆ´‰∏ÄËä±	ÊòüÂÆ´‰∏ÄËä± ÊòüÂÆÆ‰∏ÄËä±
ÊòüÈáéÊôØÂ≠ê	ÊòüÈáéÊôØÂ≠ê „Åª„Åó„ÅÆÊôØÂ≠ê
ÊòüÈáéÂ®úÁæé	ÊòüÈáéÂ®úÁæé ÊòüÈáé„Éä„Éü
ÁØ†Áî∞Ê≠•Áæé	ÁØ†Áî∞Ê≠•Áæé ÁØ†Áî∞„ÅÇ„ÇÜ„Åø
ÊüöÊú®ËíÇÂ®ú	ÊüöÊú®ËíÇÂ®ú ÊüöÊú®„ÉÜ„Ç£„Éä
ÊúâË¥∫Áî±Áà±	ÊúâË¥∫Áî±Áà± ÊúâË≥Ä„ÇÜ„ÅÇ
‰πôÁôΩÊ≤ô‰πüÂä†	‰πôÁôΩÊ≤ô‰πüÂä† ‰πôÁôΩ„Åï„ÇÑ„Åã
Ê®±‰∫ïÊ≠•	Ê®±‰∫ïÊ≠• Ê°ú‰∫ï„ÅÇ„ÇÜ
Ê®±‰∫ïÂΩ©	Ê®±‰∫ïÂΩ© Ê°ú‰∫ïÂΩ©
Ê®±Á©∫Ê°É	Ê®±Á©∫Ê°É Ê°úÁ©∫„ÇÇ„ÇÇ
ÂÆáÈÉΩÂÆ´Á¥´Ëãë	ÂÆáÈÉΩÂÆ´Á¥´Ëãë ÂÆáÈÉΩÂÆÆ„Åó„Çí„Çì
‰∏Ä‰πãÊøë‰∫öÁæéËéâ	‰∏Ä‰πãÊøë‰∫öÁæéËéâ ‰∏Ä„ÉéÁÄ¨„Ç¢„É°„É™
Ê®±Êú®Âáõ	Ê®±Êú®Âáõ Ê°úÊú®Âáõ
Âõ≠Áî∞ÁæéÊ®±	Âõ≠Áî∞ÁæéÊ®± ÂúíÁî∞„Åø„Åä„Çì
Ê∞∏ÈáéÂè∏	Ê∞∏ÈáéÂè∏ Ê∞∏Èáé„Å§„Åã„Åï
Êó©Â∑ùÊøëÈáåÂ•à	Êó©Â∑ùÊøëÈáåÂ•à Êó©Â∑ùÁÄ¨ÈáåÂ•à
Ê§éÂêçÁî±Â•à	Ê§éÂêçÁî±Â•à Ê§éÂêç„ÇÜ„Å™
Á´πÂÜÖÊúâÁ∫™	Á´πÂÜÖÊúâÁ∫™ Á´πÂÜÖÊúâÁ¥Ä
‰πôÁü≥Ê≤ô‰πüÂä†	‰πôÁü≥Ê≤ô‰πüÂä† ‰πôÁôΩ„Åï„ÇÑ„Åã
‰∏âÂÆ´Ê§ø	‰∏âÂÆ´Ê§ø ‰∏âÂÆÆ„Å§„Å∞„Åç
ËìùËäΩÊ∞¥Êúà	ËìùËäΩÊ∞¥Êúà ËóçËäΩ„Åø„Åö„Åç
ÊòüÈáéÊòé	ÊòüÈáéÊòé ÊòüÈáé„ÅÇ„Åã„Çä
Ëé≤ÂÆûÂÖãËïæÂÑø	Ëé≤ÂÆûÂÖãËïæÂÑø ËìÆÂÆü„ÇØ„É¨„Ç¢
È¶ôËãóÁé≤Èü≥	È¶ôËãóÁé≤Èü≥ È¶ôËãó„É¨„Éé„É≥
ÊúâÂéüÊ≠•Áæé	ÊúâÂéüÊ≠•Áæé ÊúâÂéü„ÅÇ„ÇÜ„Åø
ÁæéË∞∑Êú±Èáå	ÁæéË∞∑Êú±Èáå ÁæéË∞∑„ÅÇ„Åã„Çä
Ê∞¥Â∑ùÂ†á	Ê∞¥Â∑ùÂ†á Ê∞¥Â∑ù„Çπ„Éü„É¨
Â∞èÂÆµËôéÂçó	Â∞èÂÆµËôéÂçó Â∞èÂÆµ„Åì„Å™„Çì
Êñ∞ÊùëÊô∂	Êñ∞ÊùëÊô∂ Êñ∞Êùë„ÅÇ„Åã„Çä
Ê£ÆÊ≥Ω‰Ω≥Â•à	Ê£ÆÊ≥Ω‰Ω≥Â•à Ê£ÆÊ≤¢„Åã„Å™
ÊúùÊó•Â•àËä±ÊÅã	ÊúùÊó•Â•àËä±ÊÅã ÊúùÊó•Â•à„Åã„Çå„Çì
È´òÊ°•Âú£Â≠ê	È´òÊ°•Âú£Â≠ê È´òÊ©ã„Åó„Çá„ÅÜÂ≠ê
Ë•øÂÆ´Ê¢¶	Ë•øÂÆ´Ê¢¶ Ë•øÂÆÆ„ÇÜ„ÇÅ
Ëó§Ê£ÆÈáåÁ©ó	Ëó§Ê£ÆÈáåÁ©ó Ëó§Ê£ÆÈáåÁ©Ç
Êú®ÊùëÁ©ó‰πÉÈ¶ô	Êú®ÊùëÁ©ó‰πÉÈ¶ô Êú®ÊùëÁ©Ç‰πÉÈ¶ô
Á•ûÂÆ´ÂØ∫Â•àÁª™	Á•ûÂÆ´ÂØ∫Â•àÁª™ Á•ûÂÆÆÂØ∫„Éä„Ç™
Ê∞¥ÂçúÊ®±	Ê∞¥ÂçúÊ®± Ê∞¥ÂçúÊ´ª
Áà±Èü≥È∫ªÈáå‰∫ö	Áà±Èü≥È∫ªÈáå‰∫ö ÊÑõÈü≥„Åæ„Çä„ÅÇ
ËâØÈü≥Ëç†	ËâØÈü≥Ëç† ËâØÈü≥„Å™„Åö„Å™
--------------------	-------------------- 
Ë∞¢ËÄ≥Êúµ	Ë∞¢ËÄ≥Êúµ Sheldon
Ë∞¢Â∞îÈ°ø	Ë∞¢Â∞îÈ°ø Sheldon
Sheldon	Sheldon Ë∞¢Â∞îÈ°ø Ë∞¢ËÄ≥Êúµ
Ëé±Á∫≥Âæ∑	Ëé±Á∫≥Âæ∑ Leonard
Leonard	Leonard Ëé±Á∫≥Âæ∑
‰Ω©Â¶Æ	‰Ω©Â¶Æ Penny
Penny	Penny ‰Ω©Â¶Æ
ÈúçÂçéÂæ∑	ÈúçÂçéÂæ∑ Howard
Howard	Howard ÈúçÂçéÂæ∑
ÊãâÊù∞‰ªÄ	ÊãâÊù∞‰ªÄ Rajesh
Rajesh	Rajesh ÊãâÊù∞‰ªÄ
ÁëûÁßã	ÁëûÁßã Rachel
Rachel	Rachel ÁëûÁßã
Ëé´Â¶ÆÂç°	Ëé´Â¶ÆÂç° Monica
Monica	Monica Ëé´Â¶ÆÂç°
‰πî‰ºä	‰πî‰ºä Joey
Joey	Joey ‰πî‰ºä
ÁΩóÊñØ	ÁΩóÊñØ Ross
Ross	Ross ÁΩóÊñØ
Èí±Âæ∑Âãí	Èí±Âæ∑Âãí Chandler
Chandler	Chandler Èí±Âæ∑Âãí
Ëè≤ÊØî	Ëè≤ÊØî Phoebe
Phoebe	Phoebe Ëè≤ÊØî
--------------------	--------------------
Cmd	Cmd Command ‚åò
Command	Command ‚åò
Ctrl	Ctrl Control ‚åÉ
Control	Control ‚åÉ
Opt	Option ‚å•
Option	Option ‚å•
Shift	Shift ‚áß
Tab	Tab ‚á•
Caps	Caps CapsLock ‚á™
Return	Return ‚èé
Enter	Enter ‚èé
Space	Space ‚ê£
Backspace	Backspace ‚å´
Del	Del Delete ‚å´
Esc	Esc Escape ‚éã
Eject	Eject ‚èè
--------------------	--------------------
Rime	Rime „û¢
Èº†È°ªÁÆ°	Èº†È°ªÁÆ° „û¢
‰∏≠Â∑ûÈüµ	‰∏≠Â∑ûÈüµ „û¢
Â∞èÁãºÊØ´	Â∞èÁãºÊØ´ „û¢
ÂêåÊñáËæìÂÖ•Ê≥ï	ÂêåÊñáËæìÂÖ•Ê≥ï „û¢
Âπ≥ÊñπÁ±≥	Âπ≥ÊñπÁ±≥ „é°
Âπ≥ÊñπÂéòÁ±≥	Âπ≥ÊñπÂéòÁ±≥ „é†
Â∫¶	Â∫¶ ¬∞
ÊëÑÊ∞èÂ∫¶	ÊëÑÊ∞èÂ∫¶ ‚ÑÉ
ÂçéÊ∞èÂ∫¶	ÂçéÊ∞èÂ∫¶ ‚Ñâ
ÁÇπ	ÁÇπ ¬∑
Èó¥ÈöîÂè∑	Èó¥ÈöîÂè∑ ¬∑
apple	Apple Ô£ø
ÂØπ	ÂØπ ‚úì ‚úî ‚úÖ
ÂØπÂè∑	ÂØπÂè∑ ‚úì ‚úî ‚úÖ
Èîô	Èîô ‚úó ‚úò ‚ùé ‚ùå
ÈîôÂè∑	ÈîôÂè∑ ‚úó ‚úò ‚ùé ‚ùå
Âèâ	Âèâ ‚úó ‚úò ‚ùé ‚ùå
ÂèâÂè∑	ÂèâÂè∑ ‚úó ‚úò ‚ùé ‚ùå
‰∏ä	‰∏ä ‚Üë
‰∏ã	‰∏ã ‚Üì
Â∑¶	Â∑¶ ‚Üê
Âè≥	Âè≥ ‚Üí
Â∑¶‰∏ä	Â∑¶‰∏ä ‚Üñ
Â∑¶‰∏ã	Â∑¶‰∏ã ‚Üô
Âè≥‰∏ä	Âè≥‰∏ä ‚Üó
Âè≥‰∏ã	Âè≥‰∏ã ‚Üò
ÂèçÈóÆÂè∑	ÂèçÈóÆÂè∑ ¬ø
ÂÄí‰∏âËßí	ÂÄí‰∏âËßí ‚ñΩ ‚ñº
Á∫¶Á≠â‰∫é	Á∫¶Á≠â‰∫é ‚âà
Á∫¶Á≠âÂè∑	Á∫¶Á≠âÂè∑ ‚âà
‰∏çÁ≠â‰∫é	‰∏çÁ≠â‰∫é ‚â†
Â§ß‰∫é	Â§ß‰∫é >
Â§ß‰∫éÂè∑	Â§ß‰∫éÂè∑ >
Â∞è‰∫é	Â∞è‰∫é <
Â∞è‰∫éÂè∑	Â∞è‰∫éÂè∑ <
Â∞è‰∫éÁ≠â‰∫é	Â∞è‰∫éÁ≠â‰∫é ‚â§
Â∞è‰∫éÁ≠â‰∫éÂè∑	Â∞è‰∫éÁ≠â‰∫éÂè∑ ‚â§
Â§ß‰∫éÁ≠â‰∫é	Â§ß‰∫éÁ≠â‰∫é ‚â•
Â§ß‰∫éÁ≠â‰∫éÂè∑	Â§ß‰∫éÁ≠â‰∫éÂè∑ ‚â•
Ê†πÂè∑	Ê†πÂè∑ ‚àö
‰πò	‰πò √ó
‰πò‰ª•	‰πò‰ª• √ó
‰πòÂè∑	‰πòÂè∑ √ó
Èô§	Èô§ √∑
Èô§‰ª•	Èô§‰ª• √∑
Èô§Âè∑	Èô§Âè∑ √∑
Ê≠£Ë¥üÂè∑	Ê≠£Ë¥üÂè∑ ¬±
ÁôæÂàÜÂè∑	ÁôæÂàÜÂè∑ %
ÂçÉÂàÜÂè∑	ÂçÉÂàÜÂè∑ ‚Ä∞
‰∏áÂàÜÂè∑	‰∏áÂàÜÂè∑ ‚Ä±
‰∫∫Ê∞ëÂ∏Å	‰∫∫Ê∞ëÂ∏Å Ôø•
Ê∏ØÂÖÉ	Ê∏ØÂÖÉ HK$
Ê∏ØÂ∏Å	Ê∏ØÂ∏Å HK$
Êñ∞Âä†Âù°ÂÖÉ	Êñ∞Âä†Âù°ÂÖÉ S$
Êñ∞Âä†Âù°Â∏Å	Êñ∞Âä†Âù°Â∏Å S$
ÁæéÂÖÉ	ÁæéÂÖÉ $
ÁæéÂàÄ	ÁæéÂàÄ $
Ê¨ßÂÖÉ	Ê¨ßÂÖÉ ‚Ç¨
Ëã±Èïë	Ëã±Èïë ¬£
‰∫îËßíÊòü	‰∫îËßíÊòü üüâ
Áà±ÂøÉ	Áà±ÂøÉ ‚ù§Ô∏é
ÈªëÊ°É	ÈªëÊ°É ‚ô†Ô∏é
Ê¢ÖËä±	Ê¢ÖËä± ‚ô£Ô∏é
ËçâËä±	ËçâËä± ‚ô£Ô∏é
Á∫¢Ê°É	Á∫¢Ê°É ‚ô•Ô∏é
Á∫¢ÂøÉ	Á∫¢ÂøÉ ‚ô•Ô∏é
ÊñπÁâá	ÊñπÁâá ‚ô¶Ô∏é
ÊñπÂùó	ÊñπÂùó ‚ô¶Ô∏é
ÊñπÊùø	ÊñπÊùø ‚ô¶Ô∏é
Á∫≥Á≤π	Á∫≥Á≤π Âçê
Êó†Á©∑Â§ß	Êó†Á©∑Â§ß ‚àû
Êó†Á©∑Â§ßÁ¨¶Âè∑	Êó†Á©∑Â§ßÁ¨¶Âè∑ ‚àû
Ê≠£Êó†Á©∑	Ê≠£Êó†Á©∑ +‚àû
Ë¥üÊó†Á©∑	Ë¥üÊó†Á©∑ -‚àû
ÂúÜÂë®Áéá	ÂúÜÂë®Áéá œÄ
ËøõÂáªÁöÑÂ∑®‰∫∫	ËøõÂáªÁöÑÂ∑®‰∫∫ ÈÄ≤ÊíÉ„ÅÆÂ∑®‰∫∫
‰∏≠Â§ÆÁîµËßÜÂè∞	‰∏≠Â§ÆÁîµËßÜÂè∞ Ë£ÖÂû´ÂÑøÂè∞
Geralt	Geralt Êù∞Ê¥õÁâπ
Êù∞Ê¥õÁâπ	Êù∞Ê¥õÁâπ Geralt
ÁÅ≠Èú∏	ÁÅ≠Èú∏ Thanos
Thanos	Thanos ÁÅ≠Èú∏
ÁöÆÂç°‰∏ò	ÁöÆÂç°‰∏ò Pikachu
Pikachu	Pikachu ÁöÆÂç°‰∏ò
Pokemon	Pokemon Pok√©mon
